Variable	Type
insulin	I
GAD65Ab.index	I
WAIST	I
HIP	I
CORRSYS1	I
CORRDIA1	I
HIGHBP	AB
HI_CHOL	AB
HGB	I
GHB	I
CHOL1	I
trig	I
hdlc	I
ldlcalc	I
BMI1	I
MFBG	I
HOMA_IR	I
HOMA_beta	I
AGE_AT_VISIT	I
KETOACID	AB
HCT	I
c.peptide.ng.ml	I
disease_duration	I
c_peptide	AB
anemia	AB
first_deg_family	AB
hypertension	AB
lowHDL	AB
hypertriglyceridemia	AB
length_diabetic	I
Ab_pos	AB
age	I
gender	N
insulin_use	AB
